LANGUAGES CHOICES (you must include the 3 characters code of the language)


eng = English
spa = Spanish
fre = French
ger = German
ita = Italian

abk = Abkhazian
ace = Achinese
ach = Acoli
ada = Adangme
ady = Adyghe; Adygei
aar = Afar
afh = Afrihili
afr = Afrikaans
afa = Afro-Asiatic (Other)
ain = Ainu
aka = Akan
akk = Akkadian
sqi = Albanian
ale = Aleut
alg = Algonquian languages
tut = Altaic (Other)
amh = Amharic
anp = Angika
apa = Apache languages
ara = Arabic
arg = Aragonese
arp = Arapaho
arw = Arawak
hye = Armenian
rup = Aromanian; Arumanian; Macedo-Romanian
art = Artificial (Other)
asm = Assamese
ast = Asturian; Bable; Leonese; Asturleonese
ath = Athapascan languages
aus = Australian languages
map = Austronesian (Other)
ava = Avaric
ave = Avestan
awa = Awadhi
aym = Aymara
aze = Azerbaijani
ban = Balinese
bat = Baltic (Other)
bal = Baluchi
bam = Bambara
bai = Bamileke languages
bad = Banda languages
bnt = Bantu (Other)
bas = Basa
bak = Bashkir
eus = Basque
btk = Batak languages
bej = Beja; Bedawiyet
bel = Belarusian
bem = Bemba
ben = Bengali
ber = Berber (Other)
bho = Bhojpuri
bih = Bihari
bik = Bikol
bin = Bini; Edo
bis = Bislama
byn = Blin; Bilin
zbl = Blissymbols; Blissymbolics; Bliss
nob = Bokmål, Norwegian; Norwegian Bokmål
bos = Bosnian
bra = Braj
bre = Breton
bug = Buginese
bul = Bulgarian
bua = Buriat
mya = Burmese
cad = Caddo
cat = Catalan; Valencian
cau = Caucasian (Other)
ceb = Cebuano
cel = Celtic (Other)
cai = Central American Indian (Other)
khm = Central Khmer
chg = Chagatai
cmc = Chamic languages
cha = Chamorro
che = Chechen
chr = Cherokee
chy = Cheyenne
chb = Chibcha
nya = Chichewa; Chewa; Nyanja
zho = Chinese
chn = Chinook jargon
chp = Chipewyan; Dene Suline
cho = Choctaw
chu = Church Slavic; Old Slavonic; Old Bulgarian;
chk = Chuukese
chv = Chuvash
nwc = Classical Newari; Old Newari; Classical Nepal Bhasa
syc = Classical Syriac
cop = Coptic
cor = Cornish
cos = Corsican
cre = Cree
mus = Creek
crp = Creoles and pidgins (Other)
cpe = Creoles and pidgins, English based (Other)
cpf = Creoles and pidgins, French-based (Other)
cpp = Creoles and pidgins, Portuguese-based (Other)
crh = Crimean Tatar; Crimean Turkish
scr = Croatian
cus = Cushitic (Other)
cze = Czech
dak = Dakota
dan = Danish
dar = Dargwa
del = Delaware
din = Dinka
div = Divehi; Dhivehi; Maldivian
doi = Dogri
dgr = Dogrib
dra = Dravidian (Other)
dua = Duala
nl = Dutch
dum = Dutch, Middle (ca.1050-1350)
dyu = Dyula
dzo = Dzongkha
frs = Eastern Frisian
efi = Efik
egy = Egyptian (Ancient)
eka = Ekajuk
elx = Elamite
eng = English
enm = English, Middle (1100-1500)
ang = English, Old (ca.450-1100)
myv = Erzya
epo = Esperanto
est = Estonian
ewe = Ewe
ewo = Ewondo
fan = Fang
fat = Fanti
fao = Faroese
pes = Farsi
fij = Fijian
fil = Filipino; Pilipino
fin = Finnish
fiu = Finno-Ugrian (Other)
vls = Flemish
fon = Fon
fre = French
frm = French, Middle (ca.1400-1600)
fro = French, Old (842-ca.1400)
fur = Friulian
ful = Fulah
gaa = Ga
gla = Gaelic; Scottish Gaelic
car = Galibi Carib
glg = Galician
lug = Ganda
gay = Gayo
gba = Gbaya
gez = Geez
kat = Georgian
ger = German
gmh = German, Middle High (ca.1050-1500)
goh = German, Old High (ca.750-1050)
gem = Germanic (Other)
gil = Gilbertese
gon = Gondi
gor = Gorontalo
got = Gothic
grb = Grebo
grc = Greek, Ancient (to 1453)
gre = Greek, Modern (1453-)
grn = Guarani
guj = Gujarati
gwi = Gwich\'in
hai = Haida
hat = Haitian; Haitian Creole
hau = Hausa
haw = Hawaiian
heb = Hebrew
her = Herero
hil = Hiligaynon
him = Himachali
hin = Hindi
hmo = Hiri Motu
hit = Hittite
hmn = Hmong
hun = Hungarian
hup = Hupa
iba = Iban
isl = Icelandic
ido = Ido
ibo = Igbo
ijo = Ijo languages
ilo = Iloko
smn = Inari Sami
inc = Indic (Other)
ine = Indo-European (Other)
ind = Indonesian
inh = Ingush
ina = Interlingua
ile = Interlingue; Occidental
iku = Inuktitut
ipk = Inupiaq
ira = Iranian (Other)
gle = Irish
mga = Irish, Middle (900-1200)
sga = Irish, Old (to 900)
iro = Iroquoian languages
ita = Italian
jpn = Japanese
jav = Javanese
jrb = Judeo-Arabic
jpr = Judeo-Persian
kbd = Kabardian
kab = Kabyle
kac = Kachin; Jingpho
kal = Kalaallisut; Greenlandic
xal = Kalmyk; Oirat
kam = Kamba
kan = Kannada
kau = Kanuri
kaa = Kara-Kalpak
krc = Karachay-Balkar
krl = Karelian
kar = Karen languages
kas = Kashmiri
csb = Kashubian
kaw = Kawi
kaz = Kazakh
kha = Khasi
khi = Khoisan (Other)
kho = Khotanese
kik = Kikuyu; Gikuyu
kmb = Kimbundu
kin = Kinyarwanda
kir = Kirghiz; Kyrgyz
tlh = Klingon; tlhIngan-Hol
kom = Komi
kon = Kongo
kok = Konkani
kor = Korean
kos = Kosraean
kpe = Kpelle
kro = Kru languages
kua = Kuanyama; Kwanyama
kum = Kumyk
kur = Kurdish
kru = Kurukh
kut = Kutenai
lad = Ladino
lah = Lahnda
lam = Lamba
day = Land Dayak languages
lao = Lao
lat = Latin
lav = Latvian
lez = Lezghian
lim = Limburgan; Limburger; Limburgish
lin = Lingala
lit = Lithuanian
jbo = Lojban
nds = Low German; Low Saxon; German, Low;
dsb = Lower Sorbian
loz = Lozi
lub = Luba-Katanga
lua = Luba-Lulua
lui = Luiseno
smj = Lule Sami
lun = Lunda
luo = Luo (Kenya and Tanzania)
lus = Lushai
ltz = Luxembourgish; Letzeburgesch
mkd = Macedonian
mad = Madurese
mag = Magahi
mai = Maithili
mak = Makasar
mlg = Malagasy
msa = Malay
mal = Malayalam
mlt = Maltese
mnc = Manchu
mdr = Mandar
man = Mandingo
mni = Manipuri
mno = Manobo languages
glv = Manx
mri = Maori
arn = Mapudungun; Mapuche
mar = Marathi
chm = Mari
mah = Marshallese
mwr = Marwari
mas = Masai
myn = Mayan languages
men = Mende
wtm = Mewati
mic = Mi\'kmaq; Micmac
min = Minangkabau
mwl = Mirandese
moh = Mohawk
mdf = Moksha
mol = Moldavian
mkh = Mon-Khmer (Other)
lol = Mongo
mon = Mongolian
mos = Mossi
mul = Multiple languages
mun = Munda languages
nqo = N\'Ko
nah = Nahuatl languages
nau = Nauru
nav = Navajo; Navaho
nde = Ndebele, North; North Ndebele
nbl = Ndebele, South; South Ndebele
ndo = Ndonga
nap = Neapolitan
new = Nepal Bhasa; Newari
nep = Nepali
nia = Nias
nic = Niger-Kordofanian (Other)
ssa = Nilo-Saharan (Other)
niu = Niuean
nog = Nogai
non = Norse, Old
nai = North American Indian
frr = Northern Frisian
sme = Northern Sami
nno = Norwegian Nynorsk; Nynorsk, Norwegian
nor = Norwegian
nub = Nubian languages
nym = Nyamwezi
nyn = Nyankole
nyo = Nyoro
nzi = Nzima
oci = Occitan (post 1500); Provençal
arc = Official Aramaic; Imperial Aramaic
oji = Ojibwa
ori = Oriya
orm = Oromo
osa = Osage
oss = Ossetian; Ossetic
oto = Otomian languages
pal = Pahlavi
pau = Palauan
pli = Pali
pam = Pampanga; Kapampangan
pag = Pangasinan
pan = Panjabi; Punjabi
pap = Papiamento
paa = Papuan (Other)
nso = Pedi; Sepedi; Northern Sotho
per = Persian
peo = Persian, Old (ca.600-400 B.C.)
phi = Philippine (Other)
phn = Phoenician
pon = Pohnpeian
pol = Polish
por = Portuguese
pra = Prakrit languages
pro = Provençal, Old (to 1500)
pus = Pushto; Pashto
que = Quechua
roa = Rhaeto-Romanic languages
raj = Rajasthani
rap = Rapanui
rar = Rarotongan; Cook Islands Maori
qaa = Reserved for local use
rgn = Romagnolo
roa = Romance (Other)
rum = Romanian
roh = Romansh
rom = Romany
run = Rundi
rus = Russian
sal = Salishan languages
sam = Samaritan Aramaic
smi = Sami languages (Other)
smo = Samoan
sad = Sandawe
sag = Sango
san = Sanskrit
sat = Santali
srd = Sardinian
sas = Sasak
sco = Scots
sel = Selkup
sem = Semitic (Other)
srp = Serbian
srr = Serer
shn = Shan
sna = Shona
iii = Sichuan Yi; Nuosu
scn = Sicilian
sid = Sidamo
sgn = Sign Languages
bla = Siksika
snd = Sindhi
sin = Sinhala; Sinhalese
sit = Sino-Tibetan (Other)
sio = Siouan languages
sms = Skolt Sami
den = Slave (Athapascan)
sla = Slavic (Other)
slo = Slovak
slv = Slovenian
sog = Sogdian
som = Somali
son = Songhai languages
snk = Soninke
wen = Sorbian languages
sot = Sotho, Southern
sai = South American Indian (Other)
alt = Southern Altai
sma = Southern Sami
spa = Spanish
srn = Sranan Tongo
suk = Sukuma
sux = Sumerian
sun = Sundanese
sus = Susu
sot = Sutu
swa = Swahili
ssw = Swati
swe = Swedish
gsw = Swiss German; Alemannic; Alsatian
syr = Syriac
tgl = Tagalog
tah = Tahitian
tai = Tai (Other)
tgk = Tajik
tmh = Tamashek
tam = Tamil
tat = Tatar
tel = Telugu
ter = Tereno
tet = Tetum
tha = Thai
tib = Tibetan
tig = Tigre
tir = Tigrinya
tem = Timne
tiv = Tiv
tli = Tlingit
tpi = Tok Pisin
tkl = Tokelau
tog = Tonga (Nyasa)
ton = Tonga (Tonga Islands)
tsi = Tsimshian
tso = Tsonga
tsn = Tswana
tum = Tumbuka
tup = Tupi languages
tur = Turkish
ota = Turkish, Ottoman (1500-1928)
tuk = Turkmen
tvl = Tuvalu
tyv = Tuvinian
twi = Twi
udm = Udmurt
uga = Ugaritic
uig = Uighur; Uyghur
ukr = Ukrainian
umb = Umbundu
mis = Uncoded languages
und = Undetermined
hsb = Upper Sorbian
urd = Urdu
uzb = Uzbek
vai = Vai
ven = Venda
vec = Vèneto
vie = Vietnamese
vol = Volapük
vot = Votic
wak = Wakashan languages
wal = Walamo
wln = Walloon
war = Waray
was = Washo
wel = Welsh
fry = Western Frisian
wol = Wolof
xho = Xhosa
sah = Yakut
yao = Yao
yap = Yapese
yid = Yiddish
yor = Yoruba
ypk = Yupik languages
znd = Zande languages
zap = Zapotec
zza = Zaza; Dimili; Dimli; Kirdki; Kirmanjki; Zazaki
zen = Zenaga
zha = Zhuang; Chuang
zul = Zulu
zun = Zuni
